relationshipspairslash,General Audiences,Teen And Up Audiences,Mature,Explicit,Not Rated,Total
Elim Garak/Julian Bashir,1096,1238,588,751,139,3812
Jadzia Dax/Kira Nerys,159,158,35,35,7,394
Odo/Quark,94,144,47,80,7,372
non-cast/non-cast,67,106,61,56,14,304
Kira Nerys/Odo,100,85,23,25,11,244
Jadzia Dax/Worf,64,46,10,14,10,144
Julian Bashir/non-cast,31,34,38,36,4,143
Keiko O'Brien/Miles O'Brien,38,60,10,12,5,125
Corat Damar/Weyoun,13,37,21,51,2,124
Elim Garak/Kelas Parmak,38,32,23,23,2,118
Ezri Dax/Julian Bashir,36,32,17,20,7,112
Julian Bashir/Miles O'Brien,18,35,12,26,7,98
Elim Garak/non-cast,24,12,22,27,3,88
Jake Sisko/Nog,31,32,4,14,3,84
Ezri Dax/Kira Nerys,23,27,17,5,0,72
Jadzia Dax/Lenara Kahn,40,21,3,1,2,67
Benjamin Sisko/Kasidy Yates,36,14,4,5,2,61
Kira Nerys/Skrain Dukat,8,11,11,29,0,59
Skrain Dukat/non-cast,4,8,8,36,0,56
Elim Garak/Julian Bashir/Kelas Parmak,19,10,10,7,1,47
Jadzia Dax/Julian Bashir,18,7,9,5,3,42
Benjamin Sisko/Kira Nerys,27,8,5,1,1,42
Elim Garak/Skrain Dukat,1,6,8,24,0,39
Elim Garak/Tora Ziyal,15,9,6,6,0,36
Corat Damar/Kira Nerys,6,10,2,13,4,35
Kira Nerys/non-cast,8,14,6,3,3,34
Elim Garak/Odo,6,4,2,0,21,33
Keiko O'Brien/Kira Nerys/Miles O'Brien,14,12,2,3,2,33
Weyoun/non-cast,3,6,9,13,2,33
Skrain Dukat/Tora Naprem,6,14,9,4,0,33
Benjamin Sisko/Julian Bashir,2,10,14,7,0,33
Bareil Antos/Kira Nerys,11,11,6,3,1,32
Jadzia Dax/non-cast,8,11,6,6,1,32
Skrain Dukat/Weyoun,2,7,5,17,1,32
Julian Bashir/Leeta,5,11,5,7,1,29
Jake Sisko/Tora Ziyal,9,13,5,2,0,29
Leeta/Rom,10,12,2,2,2,28
Keiko O'Brien/Kira Nerys,11,9,1,6,0,27
Julian Bashir/Kira Nerys,5,8,5,7,2,27
Julian Bashir/Kelas Parmak,8,6,2,9,1,26
Corat Damar/non-cast,2,6,3,11,1,23
Ezri Dax/Lenara Kahn,12,6,3,1,1,23
Corat Damar/Skrain Dukat,1,2,4,14,1,22
Kasidy Yates/Kira Nerys,15,5,1,0,0,21
Benjamin Sisko/Skrain Dukat,4,10,2,5,0,21
Kira Nerys/Kira Nerys,2,11,2,6,0,21
Julian Bashir/Skrain Dukat,1,3,1,15,0,20
Brunt/Quark,0,8,6,6,0,20
Quark/non-cast,3,6,1,9,0,19
Kira Nerys/Shakaar Edon,3,8,4,3,1,19
Ezri Dax/Weyoun,8,5,2,4,0,19
Ezri Dax/non-cast,5,6,2,4,1,18
Enabran Tain/Mila Garak,11,5,2,0,0,18
Jadzia Dax/Leeta,5,4,3,5,0,17
Julian Bashir/Quark,0,6,4,7,0,17
Elim Garak/Julian Bashir/non-cast,1,1,0,14,0,16
Elim Garak/Weyoun,1,7,6,2,0,16
Benjamin Sisko/Kasidy Yates/Kira Nerys,12,3,1,0,0,16
Lwaxana Troi/Odo,4,4,3,2,2,15
Julian Bashir/Keiko O'Brien/Miles O'Brien,1,9,1,3,0,14
Benjamin Sisko/Jadzia Dax,1,3,3,6,1,14
Odo/non-cast,3,3,3,3,2,14
Kimara Cretak/Kira Nerys,8,6,0,0,0,14
Corat Damar/Elim Garak,3,1,1,8,1,14
Julian Bashir/Martok,1,1,3,8,0,13
Worf/non-cast,3,6,2,2,0,13
Kira Meru/Skrain Dukat,1,3,3,6,0,13
Elim Garak/Quark,2,0,2,6,1,11
Elim Garak/Worf,1,2,2,6,0,11
Keevan/Remata'Klan,1,5,2,3,0,11
Natima Lang/Quark,2,4,1,2,2,11
Q/non-cast,4,6,0,0,0,10
Grilka/Quark,0,9,0,1,0,10
Jadzia Dax/Kira Nerys/Lenara Kahn,4,4,2,0,0,10
Ezri Dax/Tora Ziyal,3,6,0,1,0,10
Benjamin Sisko/non-cast,4,3,2,1,0,10
Odo/Weyoun,2,2,2,3,1,10
Sarina Douglas/non-cast,8,1,0,0,0,9
Elim Garak/Miles O'Brien,0,0,1,8,0,9
Skrain Dukat/Winn Adami,1,6,2,0,0,9
Elim Garak/Kira Nerys,0,2,0,7,0,9
Keevan/Weyoun,0,2,3,3,0,8
Kira Nerys/Tora Ziyal,1,1,2,4,0,8
Keevan/non-cast,0,1,2,5,0,8
Hanok/Quark,0,2,4,2,0,8
Elim Garak/Ezri Dax/Julian Bashir,0,2,1,5,0,8
Julian Bashir/Sarina Douglas,3,2,2,1,0,8
Tora Ziyal/non-cast,4,2,1,1,0,8
Benjamin Sisko/Elim Garak,2,1,3,1,1,8
Ezri Dax/Worf,2,5,0,1,0,8
Miles O'Brien/non-cast,3,2,1,1,0,7
Emony Dax/non-cast,3,1,3,0,0,7
Quark/Worf,3,4,0,0,0,7
Elim Garak/Julian Bashir/Odo,4,2,0,1,0,7
Julian Bashir/Luther Sloan,0,3,1,3,0,7
Julian Bashir/Worf,1,0,2,4,0,7
Shakaar Edon/non-cast,2,3,2,0,0,7
Julian Bashir/Melora Pazlar,2,1,2,2,0,7
Pel/Quark,0,4,0,3,0,7
Nilani Kahn/Torias Dax,1,5,1,0,0,7
Kira Nerys/Miles O'Brien,1,3,1,2,0,7
Elim Garak/Pythas Lok,1,2,1,2,0,6
Elim Garak/Jadzia Dax,0,1,2,2,1,6
Jack/Kelas Parmak,1,1,2,2,0,6
Ezri Dax/Jadzia Dax,2,2,1,1,0,6
Elim Garak/Keiko O'Brien,0,0,2,4,0,6
Elim Garak/Palandine,3,2,0,1,0,6
Nog/non-cast,0,1,1,4,0,6
Ezri Dax/Quark,2,0,1,3,0,6
Benjamin Sisko/Curzon Dax,1,3,0,1,0,5
Curzon Dax/Jadzia Dax,1,2,1,1,0,5
Kira Nerys/Odo/Quark,1,3,0,0,1,5
Thomas Riker/non-cast,0,2,2,1,0,5
Skrain Dukat/Tora Ziyal,0,0,1,4,0,5
Julian Bashir/Tora Ziyal,1,1,0,3,0,5
Julian Bashir/Palis Delon,3,0,0,2,0,5
Ishka/Lwaxana Troi,2,0,1,2,0,5
Benjamin Sisko/Jennifer Sisko,3,1,1,0,0,5
Julian Bashir/Keiko O'Brien,0,3,1,1,0,5
Jack/Sarina Douglas,1,1,3,0,0,5
Kira Nerys/Lupaza,1,2,1,0,0,4
Elim Garak/Julian Bashir/Tora Ziyal,1,0,0,3,0,4
Benjamin Sisko/Quark,1,1,1,1,0,4
Kira Nerys/Leeta,0,2,0,2,0,4
Female Changeling/Odo,0,1,2,1,0,4
Remata'Klan/non-cast,0,0,0,4,0,4
Ezri Dax/Leeta,1,3,0,0,0,4
Morn/non-cast,1,2,0,1,0,4
Ezri Dax/Jake Sisko,4,0,0,0,0,4
Yelgrun/non-cast,0,2,1,1,0,4
Felix/Julian Bashir,0,1,0,3,0,4
Elim Garak/Jadzia Dax/Julian Bashir,0,0,0,3,1,4
Female Changeling/Weyoun,0,0,1,3,0,4
Kira Nerys/Quark,1,3,0,0,0,4
Eris/Weyoun,0,2,1,1,0,4
Martok/non-cast,1,0,0,3,0,4
Jake Sisko/non-cast,3,0,0,1,0,4
Keiko O'Brien/non-cast,0,1,2,0,0,3
Captain Solok/non-cast,0,2,0,0,1,3
Corat Damar/Tora Ziyal,2,0,1,0,0,3
Kelas Parmak/non-cast,0,0,3,0,0,3
Julian Bashir/Julian Bashir,0,1,0,2,0,3
Benjamin Sisko/Odo,0,0,0,2,1,3
Vreenak/non-cast,0,0,2,1,0,3
Jadzia Dax/Keiko O'Brien,0,1,0,2,0,3
Rotan'talag/Weyoun,1,1,0,1,0,3
Jack/Julian Bashir,0,0,3,0,0,3
Corat Damar/Skrain Dukat/Weyoun,0,0,1,2,0,3
Benjamin Sisko/Michael Eddington,2,1,0,0,0,3
Elim Garak/Julian Bashir/Miles O'Brien,0,0,2,1,0,3
Eris/Luaran,1,1,1,0,0,3
Enabran Tain/Julian Bashir,0,0,1,2,0,3
Julian Bashir/non-cast/non-cast,0,1,2,0,0,3
Felix/non-cast,0,1,0,2,0,3
Julian Bashir/Weyoun,0,0,2,1,0,3
Corat Damar/Ezri Dax,1,1,0,1,0,3
Arissa/Odo,0,0,0,1,2,3
Keevan/Yelgrun,1,0,2,0,0,3
Furel/Lupaza,1,1,1,0,0,3
Alexander Rozhenko/Nog,0,2,0,0,1,3
Aamin Marritza/Iliana Ghemor,2,1,0,0,0,3
Jadzia Dax/Kira Nerys/Worf,2,0,1,0,0,3
Mekor Dukat/non-cast,0,3,0,0,0,3
Jadzia Dax/Julian Bashir/Worf,0,0,2,1,0,3
Tora Naprem/non-cast,0,2,0,1,0,3
Iloja of Prim/Tobin Dax,3,0,0,0,0,3
Goran'Agar/Julian Bashir,0,2,1,0,0,3
Boheeka/Quark,0,1,1,1,0,3
Kira Nerys/Worf,0,0,1,1,0,2
Enabran Tain/Kelas Parmak,0,0,1,1,0,2
Dax/Lenara Kahn,0,1,1,0,0,2
Opaka/Winn Adami,1,1,0,0,0,2
Worf/non-cast/non-cast,0,2,0,0,0,2
Laas/Odo,1,1,0,0,0,2
Quark/Vic Fontaine,0,1,1,0,0,2
Gilora Rejal/non-cast,0,0,0,2,0,2
Joseph Sisko/Sarah Sisko,1,0,1,0,0,2
Benjamin Sisko/Vic Fontaine,1,1,0,0,0,2
Kira Nerys/Winn Adami,0,1,0,0,1,2
Natima Lang/Tora Naprem,0,0,1,1,0,2
Borath/non-cast,0,1,1,0,0,2
Joseph Sisko/non-cast,0,1,1,0,0,2
Corat Damar/Keevan,0,0,0,2,0,2
Reese/non-cast,0,1,1,0,0,2
Jadzia Dax/Melora Pazlar,2,0,0,0,0,2
Elim Garak/Julian Bashir/Skrain Dukat,1,0,0,1,0,2
Elim Garak/Enabran Tain,0,1,1,0,0,2
Chalan Aroya/Odo,0,2,0,0,0,2
Enabran Tain/Martok,0,1,1,0,0,2
Julian Bashir/Odo,0,1,0,0,1,2
Julian Bashir/Q,0,1,1,0,0,2
Jaro Essa/Winn Adami,1,1,0,0,0,2
Corat Damar/Skrain Dukat/non-cast,0,0,1,1,0,2
Grilka/Natima Lang,0,0,1,1,0,2
Ezri Dax/Jadzia Dax/Kira Nerys,1,0,1,0,0,2
Jadzia Dax/Odo,0,1,0,1,0,2
Jadzia Dax/Kira Nerys/Odo,0,0,0,1,1,2
Amsha Bashir/Richard Bashir,0,2,0,0,0,2
Keevan/Skrain Dukat,0,1,0,1,0,2
Dax/non-cast,0,0,1,1,0,2
Corat Damar/Julian Bashir,1,1,0,0,0,2
Curzon Dax/Quark,0,2,0,0,0,2
Enabran Tain/non-cast,0,1,0,1,0,2
Kilana/non-cast,0,0,1,1,0,2
Jake Sisko/Kesha,1,1,0,0,0,2
Dax/Worf,0,2,0,0,0,2
Kira Nerys/non-cast/non-cast,2,0,0,0,0,2
Benjamin Sisko/Ezri Dax,0,0,0,2,0,2
K'Ehleyr/Worf,1,1,0,0,0,2
Elim Garak/Julian Bashir/Keiko O'Brien/Miles O'Brien,0,0,1,1,0,2
Barkan Lokar/Elim Garak/Palandine,0,0,0,2,0,2
Odo/Worf,1,1,0,0,0,2
Ishka/Keldar,0,1,0,1,0,2
Akellen Macet/Elim Garak,0,1,1,0,0,2
Corat Damar/Mila Garak,0,2,0,0,0,2
Morn/Quark,1,1,0,0,0,2
Ishka/Zek,0,1,1,0,0,2
Elim Garak/Lwaxana Troi,0,0,1,1,0,2
Elim Garak/Julian Bashir/Julian Bashir,0,1,0,1,0,2
Benjamin Sisko/Rom,1,0,0,1,0,2
Winn Adami/non-cast,0,1,1,0,0,2
Julian Bashir/Leeta/Rom,1,1,0,0,0,2
Leeta/Winn Adami,0,2,0,0,0,2
Gelnon/non-cast,0,0,1,0,0,1
Eris/non-cast,0,0,1,0,0,1
Deyos/non-cast,0,0,1,0,0,1
Julian Bashir/Kaga,1,0,0,0,0,1
Luaran/non-cast,0,0,1,0,0,1
Corat Damar/Ezri Dax/Kira Nerys/Weyoun,0,0,0,1,0,1
Elim Garak/Kaga,1,0,0,0,0,1
Benjamin Sisko/Tora Ziyal,0,0,0,1,0,1
Kira Nerys/Weyoun,0,0,0,1,0,1
Kira Nerys/Odo/non-cast,0,0,0,1,0,1
Grilka/Natima Lang/Quark,0,0,0,1,0,1
Benjamin Sisko/Morn/Zek/non-cast,0,0,1,0,0,1
Jadzia Dax/Julian Bashir/non-cast,0,0,0,0,1,1
Keevan/Remata'Klan/non-cast,0,0,0,1,0,1
Rom/non-cast,0,1,0,0,0,1
Curzon Dax/non-cast,0,1,0,0,0,1
Torias Dax/non-cast,0,1,0,0,0,1
Kimara Cretak/T'Rul,0,0,1,0,0,1
Benjamin Sisko/Miles O'Brien,1,0,0,0,0,1
Elim Garak/Ezri Dax/Kira Nerys/non-cast,0,0,0,1,0,1
Julian Bashir/Lieutenant Watley,0,1,0,0,0,1
Mavek/non-cast,0,0,0,1,0,1
Benjamin Sisko/Curzon Dax/Jadzia Dax,0,0,0,1,0,1
Jadzia Dax/Kilana,0,0,1,0,0,1
Kaga/non-cast,0,0,1,0,0,1
Jadzia Dax/Kasidy Yates,0,0,0,1,0,1
Benjamin Sisko/Elim Garak/Ezri Dax/Jadzia Dax/Julian Bashir/Kasidy Yates/Keiko O'Brien/Kira Nerys/Leeta/Miles O'Brien/Odo/Quark/Rom/Worf,0,1,0,0,0,1
Benjamin Sisko/Q,1,0,0,0,0,1
Elim Garak/Julian Bashir/Keiko O'Brien,0,0,0,1,0,1
Cox/Kira Nerys,0,1,0,0,0,1
Cox/non-cast,0,1,0,0,0,1
Dax/Elim Garak/Julian Bashir/Worf,0,0,0,1,0,1
Skrain Dukat/Weyoun/Weyoun,0,0,0,1,0,1
Weyoun/Weyoun,0,0,0,1,0,1
Kasidy Yates/Keiko O'Brien/Miles O'Brien,1,0,0,0,0,1
Boday/Julian Bashir,0,0,0,1,0,1
Bareil Antos/Morn,0,1,0,0,0,1
Bareil Antos/Benjamin Sisko/Elim Garak/Ezri Dax/Jadzia Dax/Julian Bashir/Kasidy Yates/Keiko O'Brien/Kira Nerys/Leeta/Miles O'Brien/Odo/Quark/Rom/Shakaar Edon/Worf,0,1,0,0,0,1
Curzon Dax/Elim Garak/Julian Bashir/Odo,0,1,0,0,0,1
Elim Garak/Julian Bashir/Quark,0,0,0,1,0,1
Curzon Dax/Elim Garak/Odo,0,1,0,0,0,1
Alexander Rozhenko/Jake Sisko/Nog,0,1,0,0,0,1
Ezri Dax/Kilana,0,1,0,0,0,1
Elim Garak/Ezri Dax,0,0,0,1,0,1
Elim Garak/Joseph Sisko,1,0,0,0,0,1
Elim Garak/Julian Bashir/Weyoun,0,0,1,0,0,1
Kela Idaris/non-cast,0,1,0,0,0,1
Ziranne Idaris/non-cast,0,1,0,0,0,1
Corat Damar/Elim Garak/non-cast,0,0,1,0,0,1
Julian Bashir/Winn Adami,0,1,0,0,0,1
Kira Nerys/Tekeny Ghemor,0,1,0,0,0,1
Alexander Rozhenko/Julian Bashir,0,1,0,0,0,1
Quark/Skrain Dukat,0,0,0,1,0,1
Julian Bashir/Martok/Sirella,0,0,0,1,0,1
Elim Garak/Richard Bashir,0,0,0,1,0,1
Benjamin Sisko/Captain Solok,0,1,0,0,0,1
Benjamin Sisko/Curzon Dax/non-cast,0,1,0,0,0,1
Kasidy Yates/Keiko O'Brien,0,1,0,0,0,1
Benjamin Sisko/Dax,0,1,0,0,0,1
Elim Garak/Kira Nerys/Worf,0,0,0,1,0,1
Ellis Gareth/Julian Bashir,0,0,1,0,0,1
Eris/Kilana,0,0,1,0,0,1
Deral/Julian Bashir,0,1,0,0,0,1
Pel/non-cast,0,0,0,1,0,1
Gor/Weyoun,0,0,0,1,0,1
Alexander Rozhenko/Ch'Targh,0,0,1,0,0,1
Ezri Dax/Nog,0,0,0,1,0,1
Curzon Dax/Julian Bashir/Odo,0,0,0,1,0,1
Julian Bashir/Lwaxana Troi,0,0,0,1,0,1
Elim Garak/Julian Bashir/Kaga,0,0,0,1,0,1
Benjamin Sisko/Kasidy Yates/Weyoun,1,0,0,0,0,1
Benjamin Sisko/Weyoun,1,0,0,0,0,1
Kasidy Yates/Weyoun,1,0,0,0,0,1
Benjamin Sisko/Ezri Dax/Kasidy Yates,0,0,0,1,0,1
Curzon Dax/Julian Bashir,0,1,0,0,0,1
Elim Garak/Keiko O'Brien/Kelas Parmak/Miles O'Brien,0,0,0,1,0,1
Amsha Bashir/Elim Garak,0,0,0,1,0,1
Amsha Bashir/Elim Garak/Richard Bashir,0,0,0,1,0,1
Brunt/non-cast,0,0,0,1,0,1
Julian Bashir/Keiko O'Brien/Kira Nerys/Miles O'Brien,0,1,0,0,0,1
Corat Damar/Quark,0,0,1,0,0,1
Grilka/Lenara Kahn/non-cast,0,1,0,0,0,1
Jadzia Dax/Jennifer Sisko,0,1,0,0,0,1
Vash/non-cast,0,1,0,0,0,1
Borath/Weyoun,0,0,0,1,0,1
Emergency Medical Hologram Mark II/non-cast,0,1,0,0,0,1
Elim Garak/Quark/non-cast,1,0,0,0,0,1
Iliana Ghemor/Tora Ziyal,0,1,0,0,0,1
Ezri Dax/Vic Fontaine,0,1,0,0,0,1
Ezri Dax/Lauren,0,0,1,0,0,1
Leeta/Zek/non-cast,0,0,1,0,0,1
Corat Damar/Gul Rusot,0,0,0,1,0,1
Gowron/Julian Bashir,0,0,1,0,0,1
Elim Garak/Julian Bashir/Kira Nerys,0,1,0,0,0,1
Bareil Antos/Julian Bashir,0,1,0,0,0,1
Miles O'Brien/Worf,0,0,0,1,0,1
Jadzia Dax/Jadzia Dax,0,1,0,0,0,1
Lwaxana Troi/Odo/Quark,0,1,0,0,0,1
Lwaxana Troi/Quark,0,1,0,0,0,1
Elim Garak/Morn,1,0,0,0,0,1
Elim Garak/Worf/non-cast,0,1,0,0,0,1
Kimara Cretak/non-cast,0,1,0,0,0,1
Jack/non-cast,0,0,1,0,0,1
Benjamin Sisko/Jennifer Sisko/Kasidy Yates,1,0,0,0,0,1
Lauren/non-cast,1,0,0,0,0,1
Elim Garak/Luther Sloan,0,0,0,0,1,1
Odo/Skrain Dukat,0,0,0,0,1,1
Dax/Julian Bashir/Kira Nerys/Odo,0,0,0,0,1,1
Elim Garak/Opaka,0,1,0,0,0,1
Ishka/Jadzia Dax,0,1,0,0,0,1
Jennifer Sisko/Miles O'Brien,0,1,0,0,0,1
Bareil Antos/Winn Adami,0,1,0,0,0,1
Dax/Kira Nerys,0,1,0,0,0,1
Kira Nerys/Vic Fontaine,0,0,1,0,0,1
Elim Garak/Keevan,0,0,0,1,0,1
Martok/Sirella,1,0,0,0,0,1
Ezri Dax/Jadzia Dax/non-cast,0,0,0,0,1,1
Mareel/Verad,0,1,0,0,0,1
Alexander Rozhenko/Lauren,0,0,1,0,0,1
Boday/Jadzia Dax,0,1,0,0,0,1
Jake Sisko/Laira,0,1,0,0,0,1
Jake Sisko/Mardah,0,1,0,0,0,1
Jadzia Dax/Keiko O'Brien/Kira Nerys,0,0,1,0,0,1
Prinadora/Rom,0,1,0,0,0,1
Lela Dax/non-cast,0,0,0,1,0,1
Dax/Jadzia Dax,1,0,0,0,0,1
Deyos/Weyoun,0,0,0,0,1,1
Luaran/Yelgrun,0,0,0,0,1,1
Ezri Dax/Skrain Dukat,1,0,0,0,0,1
Julian Bashir/Kukalaka,0,0,1,0,0,1
Tekeny Ghemor/non-cast,0,0,1,0,0,1
Keevan/Weyoun/non-cast,0,0,0,1,0,1
Elim Garak/Winn Adami,0,0,1,0,0,1
Elim Garak/Julian Bashir/Miles O'Brien/non-cast/non-cast,0,1,0,0,0,1
Elim Garak/Julian Bashir/non-cast/non-cast,0,1,0,0,0,1
Bareil Antos/Benjamin Sisko,0,0,0,1,0,1
Elim Garak/Kai Winn,0,0,0,1,0,1
Michael Eddington/Rebecca Sullivan,0,1,0,0,0,1
Deral/Jadzia Dax,1,0,0,0,0,1
Keiko O'Brien/Kira Nerys/Miles O'Brien/non-cast,0,1,0,0,0,1
Gowron/non-cast,0,0,0,1,0,1
Elim Garak/Procal Dukat,0,1,0,0,0,1
Skrain Dukat/Vreenak/non-cast,0,0,0,1,0,1
Kira Nerys/Natima Lang,1,0,0,0,0,1
Kai Winn/Skrain Dukat,1,0,0,0,0,1
Kaga/Quark,0,0,1,0,0,1
Omet'iklan/Weyoun,0,0,0,1,0,1
Jadzia Dax/Julian Bashir/Kira Nerys,0,0,0,1,0,1
Dax/Julian Bashir,0,1,0,0,0,1
Elim Garak/Kelas Parmak/Tora Ziyal,0,0,0,1,0,1
Kelas Parmak/Tora Ziyal,0,0,0,1,0,1
Elim Garak/Julian Bashir/Morn,0,1,0,0,0,1
Jadzia Dax/K'Ehleyr/Worf,0,0,1,0,0,1
Drex/Elim Garak,0,0,0,1,0,1
Athra Dukat/Skrain Dukat,0,1,0,0,0,1
Lwaxana Troi/Mora Pol,0,0,1,0,0,1
Elim Garak/Q,0,0,1,0,0,1
Elim Garak/Skrain Dukat/Tora Naprem,0,0,0,1,0,1
Jadzia Dax/Kira Nerys/Leeta/Lenara Kahn,0,1,0,0,0,1
Elim Garak/Kelas Parmak/Pythas Lok,0,0,0,1,0,1
Corat Damar/Elim Garak/Julian Bashir,1,0,0,0,0,1
Gilora Rejal/Nal Dejar,0,0,0,1,0,1
Leeta/Quark,0,1,0,0,0,1
Corat Damar/Niala Damar,0,0,0,0,1,1
Kelas Parmak/Pythas Lok,0,0,0,1,0,1
Miles O'Brien/non-cast/non-cast,0,1,0,0,0,1
Quark/Vash,0,1,0,0,0,1
Jadzia Dax/Julian Bashir/Kira Nerys/non-cast,1,0,0,0,0,1
Keevan/Kilana,0,0,1,0,0,1
Jadzia Dax/Julian Bashir/Leeta,0,0,1,0,0,1
Elim Garak/Skrain Dukat/Weyoun,0,0,0,1,0,1
Elim Garak/Jadzia Dax/non-cast,0,0,0,1,0,1
Elim Garak/Jack,0,0,0,1,0,1
Corat Damar/Jadzia Dax,0,0,0,1,0,1
Athra Dukat/Tora Naprem,0,1,0,0,0,1
Kira Nerys/Tahna Los,0,1,0,0,0,1
Kira Nerys/Kira Reon,0,1,0,0,0,1
Alexander Rozhenko/non-cast,1,0,0,0,0,1
Kira Meru/non-cast,0,1,0,0,0,1
Kira Nerys/Lenara Kahn,1,0,0,0,0,1
Julian Bashir/Lauren,0,0,1,0,0,1
Total,2382,2737,1294,1774,306,8493
