relationshipspairslash,No Archive Warnings Apply,Choose Not To Use Archive Warnings,Graphic Depictions Of Violence,Major Character Death,Rape/Non-Con,Underage,Total
Elim Garak/Julian Bashir,3073,661,74,52,52,6,3918
Jadzia Dax/Kira Nerys,350,50,1,15,1,0,417
Odo/Quark,320,46,3,6,2,0,377
non-cast/non-cast,194,73,23,15,8,3,316
Kira Nerys/Odo,161,77,7,8,3,0,256
Julian Bashir/non-cast,99,29,9,7,9,0,153
Jadzia Dax/Worf,104,34,4,9,1,0,152
Keiko O'Brien/Miles O'Brien,106,16,3,1,1,0,127
Corat Damar/Weyoun,83,27,5,5,8,0,128
Elim Garak/Kelas Parmak,99,16,2,3,1,1,122
Ezri Dax/Julian Bashir,81,25,3,4,1,0,114
Julian Bashir/Miles O'Brien,87,8,3,1,1,0,100
Elim Garak/non-cast,53,24,11,0,5,2,95
Jake Sisko/Nog,70,9,2,1,1,1,84
Ezri Dax/Kira Nerys,49,16,3,5,0,0,73
Jadzia Dax/Lenara Kahn,62,8,0,3,0,0,73
Benjamin Sisko/Kasidy Yates,45,14,6,3,0,0,68
Kira Nerys/Skrain Dukat,34,15,2,2,9,0,62
Skrain Dukat/non-cast,24,24,2,1,6,0,57
Keiko O'Brien/Kira Nerys,53,3,1,0,0,0,57
Jadzia Dax/Julian Bashir,34,8,3,0,1,0,46
Benjamin Sisko/Kira Nerys,38,3,0,1,0,0,42
Elim Garak/Skrain Dukat,23,12,1,2,4,1,43
Elim Garak/Tora Ziyal,21,15,1,2,0,0,39
Kira Nerys/non-cast,25,7,3,0,2,0,37
Corat Damar/Kira Nerys,25,4,5,1,0,0,35
Skrain Dukat/Tora Naprem,20,9,2,1,1,0,33
Elim Garak/Odo,13,20,0,0,0,0,33
Weyoun/non-cast,14,16,2,1,2,0,35
Benjamin Sisko/Julian Bashir,30,2,0,0,1,0,33
Bareil Antos/Kira Nerys,23,6,0,3,0,0,32
Skrain Dukat/Weyoun,16,13,1,0,2,0,32
Jadzia Dax/non-cast,27,1,3,1,1,0,33
Julian Bashir/Leeta,29,2,0,0,0,0,31
Jake Sisko/Tora Ziyal,23,5,1,3,0,0,32
Leeta/Rom,23,4,1,2,0,0,30
Julian Bashir/Kira Nerys,24,4,0,0,0,0,28
Julian Bashir/Kelas Parmak,23,3,0,1,0,0,27
Corat Damar/Skrain Dukat,12,11,1,1,1,0,26
Ezri Dax/Lenara Kahn,20,1,1,1,0,0,23
Corat Damar/non-cast,10,11,2,2,0,0,25
Kasidy Yates/Kira Nerys,19,1,0,1,0,0,21
Kira Nerys/Kira Nerys,14,5,0,1,2,0,22
Benjamin Sisko/Skrain Dukat,16,6,0,1,0,0,23
Brunt/Quark,17,3,0,0,0,0,20
Julian Bashir/Skrain Dukat,6,9,0,1,5,0,21
Quark/non-cast,17,1,1,0,1,0,20
Ezri Dax/Weyoun,18,1,0,0,0,0,19
Kira Nerys/Shakaar Edon,14,5,0,0,1,0,20
Enabran Tain/Mila Garak,12,7,1,0,0,0,20
Ezri Dax/non-cast,14,3,0,2,0,0,19
Julian Bashir/Quark,16,2,0,0,0,0,18
Jadzia Dax/Leeta,14,3,0,0,0,0,17
Corat Damar/Elim Garak,8,5,2,0,2,0,17
Elim Garak/Weyoun,14,1,1,0,0,0,16
Lwaxana Troi/Odo,11,5,0,0,1,0,17
Julian Bashir/Keiko O'Brien,14,1,0,0,0,0,15
Kimara Cretak/Kira Nerys,12,2,0,0,0,0,14
Worf/non-cast,10,3,1,1,1,0,16
Odo/non-cast,8,5,1,0,0,0,14
Benjamin Sisko/Jadzia Dax,14,0,0,0,0,0,14
Julian Bashir/Martok,7,5,0,0,1,0,13
Kira Meru/Skrain Dukat,3,9,1,0,1,0,14
Elim Garak/Quark,8,3,1,0,0,0,12
Keevan/Remata'Klan,6,1,5,0,1,0,13
Elim Garak/Jadzia Dax,9,2,0,0,0,0,11
Elim Garak/Worf,7,2,2,0,0,0,11
Natima Lang/Quark,8,4,0,0,0,0,12
Ezri Dax/Tora Ziyal,10,0,0,0,0,0,10
Q/non-cast,8,2,0,0,0,0,10
Grilka/Quark,7,2,1,0,0,0,10
Elim Garak/Kira Nerys,4,7,0,0,0,0,11
Benjamin Sisko/non-cast,8,2,0,0,0,0,10
Odo/Weyoun,9,0,1,0,1,0,11
Keevan/Weyoun,6,1,2,1,0,0,10
Sarina Douglas/non-cast,8,1,0,0,0,0,9
Elim Garak/Miles O'Brien,5,3,1,0,0,0,9
Skrain Dukat/Winn Adami,6,2,0,1,0,0,9
Tora Ziyal/non-cast,7,1,0,0,0,0,8
Keevan/non-cast,1,4,2,0,3,0,10
Julian Bashir/Sarina Douglas,6,2,0,0,0,0,8
Hanok/Quark,6,2,0,0,0,0,8
Ezri Dax/Worf,5,2,0,0,1,0,8
Elim Garak/Ezri Dax,6,2,0,0,0,0,8
Benjamin Sisko/Elim Garak,6,1,1,1,0,0,9
Kira Nerys/Tora Ziyal,5,1,0,1,1,0,8
Elim Garak/Keiko O'Brien,4,3,0,0,0,0,7
Nilani Kahn/Torias Dax,5,0,0,2,0,0,7
Julian Bashir/Luther Sloan,6,0,1,1,0,0,8
Julian Bashir/Worf,5,2,0,0,0,0,7
Emony Dax/non-cast,4,3,0,0,0,0,7
Kira Nerys/Miles O'Brien,6,1,0,0,0,0,7
Julian Bashir/Melora Pazlar,7,0,0,0,0,0,7
Miles O'Brien/non-cast,5,2,0,0,0,0,7
Quark/Worf,7,0,0,0,0,0,7
Ezri Dax/Jadzia Dax,5,1,1,0,0,0,7
Shakaar Edon/non-cast,6,0,0,0,1,0,7
Pel/Quark,6,0,0,0,1,0,7
Elim Garak/Pythas Lok,5,1,0,0,0,0,6
Nog/non-cast,2,2,1,1,1,0,7
Jack/Kelas Parmak,1,5,0,0,0,0,6
Ezri Dax/Quark,6,0,0,0,0,0,6
Elim Garak/Palandine,6,0,0,0,0,0,6
Benjamin Sisko/Jennifer Sisko,4,1,1,0,0,0,6
Julian Bashir/Palis Delon,5,0,0,0,0,0,5
Ishka/Lwaxana Troi,5,0,0,0,0,0,5
Thomas Riker/non-cast,3,1,1,0,0,0,5
Skrain Dukat/Tora Ziyal,1,2,0,0,2,1,6
Benjamin Sisko/Curzon Dax,5,0,0,0,0,0,5
Curzon Dax/Jadzia Dax,3,2,0,0,0,0,5
Julian Bashir/Tora Ziyal,4,0,1,0,0,0,5
Jack/Sarina Douglas,3,1,1,0,0,0,5
Felix/Julian Bashir,4,0,0,0,0,0,4
Martok/non-cast,3,1,0,0,0,0,4
Ezri Dax/Leeta,3,1,0,0,0,0,4
Yelgrun/non-cast,1,2,1,0,0,0,4
Benjamin Sisko/Quark,4,0,0,0,0,0,4
Kira Nerys/Leeta,3,1,0,0,0,0,4
Eris/Weyoun,2,1,1,1,0,0,5
Female Changeling/Weyoun,3,1,0,1,2,0,7
Kira Nerys/Lupaza,3,1,0,0,0,0,4
Jake Sisko/non-cast,2,2,0,0,0,0,4
Kira Nerys/Quark,4,0,0,0,0,0,4
Jadzia Dax/Keiko O'Brien,2,2,0,0,0,0,4
Female Changeling/Odo,2,2,0,0,0,0,4
Remata'Klan/non-cast,0,0,2,0,4,0,6
Benjamin Sisko/Ezri Dax,4,0,0,0,0,0,4
Morn/non-cast,2,2,0,0,0,0,4
Ezri Dax/Jake Sisko,4,0,0,0,0,0,4
Felix/non-cast,3,0,0,0,0,0,3
Boheeka/Quark,1,2,0,0,0,0,3
Jack/Julian Bashir,0,3,0,0,0,0,3
Furel/Lupaza,2,0,0,0,1,0,3
Julian Bashir/Weyoun,2,0,1,0,0,0,3
Kelas Parmak/non-cast,3,0,0,0,0,0,3
Benjamin Sisko/Odo,1,1,0,0,1,0,3
Captain Solok/non-cast,1,2,0,0,0,0,3
Arissa/Odo,3,1,0,0,0,0,4
Keiko O'Brien/non-cast,2,0,0,0,1,0,3
Rotan'talag/Weyoun,2,0,1,0,0,0,3
Benjamin Sisko/Michael Eddington,3,0,0,0,0,0,3
Eris/Luaran,2,0,1,0,0,0,3
Iloja of Prim/Tobin Dax,2,1,0,0,0,0,3
Keevan/Yelgrun,2,1,0,0,0,0,3
Enabran Tain/Julian Bashir,1,0,2,1,1,0,5
Mekor Dukat/non-cast,3,0,0,0,0,0,3
Aamin Marritza/Iliana Ghemor,2,1,0,0,0,0,3
Tora Naprem/non-cast,3,0,0,0,0,0,3
Vreenak/non-cast,0,3,0,0,0,0,3
Alexander Rozhenko/Nog,1,2,0,0,0,0,3
Goran'Agar/Julian Bashir,3,0,0,0,0,0,3
Corat Damar/Ezri Dax,3,1,0,0,0,0,4
Julian Bashir/Julian Bashir,3,1,0,0,0,0,4
Corat Damar/Tora Ziyal,2,1,1,0,0,0,4
Spock/non-cast,2,1,0,0,0,0,3
Enabran Tain/non-cast,2,0,0,0,0,0,2
Enabran Tain/Kelas Parmak,0,2,0,0,0,0,2
Dax/non-cast,1,1,0,0,0,0,2
Reese/non-cast,2,0,0,0,0,0,2
Natima Lang/Tora Naprem,2,0,0,0,0,0,2
Jadzia Dax/Melora Pazlar,2,0,0,0,0,0,2
Jake Sisko/Kesha,2,0,0,0,0,0,2
Enabran Tain/Martok,2,0,0,0,0,0,2
Julian Bashir/Q,2,0,0,0,0,0,2
Amsha Bashir/Richard Bashir,1,1,0,0,0,0,2
Kira Nerys/Winn Adami,1,1,0,0,0,0,2
Laas/Odo,2,0,0,0,0,0,2
Benjamin Sisko/Vic Fontaine,1,1,0,0,0,0,2
Dax/Lenara Kahn,2,0,0,0,0,0,2
Gilora Rejal/non-cast,2,0,0,0,0,0,2
Kilana/non-cast,1,1,0,0,0,0,2
Quark/Vic Fontaine,2,0,0,0,0,0,2
Keevan/Skrain Dukat,0,1,0,0,1,0,2
Winn Adami/non-cast,1,1,0,0,0,0,2
Jaro Essa/Winn Adami,2,0,0,0,0,0,2
Bareil Antos/Benjamin Sisko,2,0,0,0,0,0,2
Borath/non-cast,0,1,1,0,0,0,2
Tom Paris/non-cast,1,0,1,0,0,0,2
Corat Damar/Keevan,2,0,0,0,0,0,2
Jadzia Dax/Odo,2,0,0,0,0,0,2
Kira Nerys/Worf,0,2,0,0,0,0,2
Corat Damar/Mila Garak,2,0,0,0,0,0,2
Ishka/Zek,2,0,0,0,0,0,2
Curzon Dax/Quark,2,0,0,0,0,0,2
Chalan Aroya/Odo,2,0,0,0,0,0,2
Corat Damar/Julian Bashir,2,0,0,0,0,0,2
Grilka/Natima Lang,1,1,0,0,0,0,2
Ishka/Keldar,1,0,1,0,1,0,3
Akellen Macet/Elim Garak,0,1,0,0,1,1,3
Joseph Sisko/non-cast,0,0,0,0,2,0,2
Dax/Worf,2,0,0,0,0,0,2
Leeta/Winn Adami,2,0,0,0,0,0,2
Curzon Dax/Julian Bashir,2,0,0,0,0,0,2
Julian Bashir/Odo,2,0,0,0,0,0,2
Elim Garak/Lwaxana Troi,2,0,0,0,0,0,2
Opaka/Winn Adami,1,1,0,0,0,0,2
Dax/Julian Bashir,2,0,0,0,0,0,2
Morn/Quark,1,1,0,0,0,0,2
Odo/Worf,2,0,0,0,0,0,2
Elim Garak/Enabran Tain,2,1,0,0,0,0,3
Barkan Lokar/Elim Garak,1,2,0,0,0,0,3
Kasidy Yates/Keiko O'Brien,1,1,0,0,0,0,2
K'Ehleyr/Worf,2,0,0,0,0,0,2
Benjamin Sisko/Rom,1,1,0,0,0,0,2
Joseph Sisko/Sarah Sisko,1,0,0,0,1,0,2
Corat Damar/Quark,1,0,0,0,0,0,1
Han Solo/Luke Skywalker,1,0,0,0,0,0,1
Eris/Kilana,1,0,0,0,0,0,1
Alexander Rozhenko/Jake Sisko,0,1,0,0,0,0,1
Deral/Julian Bashir,1,0,0,0,0,0,1
Rom/non-cast,1,0,0,0,0,0,1
Ray Vecchio/non-cast,1,0,0,0,0,0,1
Julian Bashir/Lwaxana Troi,1,0,0,0,0,0,1
Jadzia Dax/Kilana,0,0,1,1,0,0,2
The Doctor/non-cast,1,0,0,0,0,0,1
Rose Tyler/non-cast,1,0,0,0,0,0,1
Ezri Dax/Kilana,1,0,0,0,0,0,1
Kaga/Quark,1,0,0,0,0,0,1
Omet'iklan/Weyoun,0,1,0,1,1,0,3
Kelas Parmak/Tora Ziyal,1,0,0,0,0,0,1
Julian Bashir/Winn Adami,1,0,0,0,0,0,1
Elim Garak/Joseph Sisko,1,0,0,0,0,0,1
Ezri Dax/Nog,1,0,0,0,0,0,1
Kela Idaris/non-cast,1,0,0,0,0,0,1
Alexander Rozhenko/Ch'Targh,0,1,0,0,0,0,1
Jadzia Dax/K'Ehleyr,1,0,0,0,0,0,1
Ziranne Idaris/non-cast,1,0,0,0,0,0,1
Kira Nerys/Tekeny Ghemor,1,0,0,0,0,0,1
Brunt/non-cast,1,0,0,0,0,0,1
Drex/Elim Garak,0,0,1,0,1,0,2
Gor/Weyoun,0,0,0,0,1,0,1
Athra Dukat/Skrain Dukat,1,0,0,0,0,0,1
Quark/Skrain Dukat,1,0,0,0,0,0,1
Mavek/non-cast,0,1,0,0,0,0,1
Julian Bashir/Kaga,1,0,0,0,0,0,1
Benjamin Sisko/Weyoun,1,0,0,0,0,0,1
Amsha Bashir/Elim Garak,1,0,0,0,0,0,1
Benjamin Sisko/Miles O'Brien,1,0,0,0,0,0,1
Benjamin Sisko/Q,1,1,0,0,0,0,2
Elim Garak/Richard Bashir,1,0,0,0,0,0,1
Jasper Hale/Rosalie Hale,1,0,0,0,0,0,1
Benjamin Sisko/Captain Solok,1,0,0,0,0,0,1
Ezri Dax/Garak,1,0,0,0,0,0,1
Alexander Rozhenko/Julian Bashir,0,1,0,0,0,0,1
Jadzia Dax/Kasidy Yates,1,0,0,0,0,0,1
Julian Bashir/Lieutenant Watley,0,1,0,0,0,0,1
Luaran/non-cast,0,1,0,0,0,0,1
Kaga/non-cast,1,0,0,0,0,0,1
Benjamin Sisko/Tora Ziyal,1,0,0,0,0,0,1
Elim Garak/Kaga,1,0,0,0,0,0,1
Gelnon/non-cast,0,1,0,0,0,0,1
Eris/non-cast,0,1,0,0,0,0,1
Benjamin Sisko/Dax,1,0,0,0,0,0,1
Kimara Cretak/T'Rul,0,0,0,0,1,0,1
Kasidy Yates/Weyoun,1,0,0,0,0,0,1
Kathryn Janeway/non-cast,1,0,0,0,0,0,1
Curzon Dax/Elim Garak,1,0,0,0,0,0,1
Deyos/non-cast,0,1,0,0,0,0,1
Bareil Antos/Morn,0,1,0,0,0,0,1
Kira Nerys/Weyoun,1,0,0,0,0,0,1
Benjamin Sisko/Morn,1,0,0,0,0,0,1
Boday/Julian Bashir,1,0,0,0,0,0,1
Weyoun/Weyoun,1,0,0,0,0,0,1
Corat Damar/Reader,0,1,0,0,0,0,1
Ellis Gareth/Julian Bashir,1,0,0,0,0,0,1
Curzon Dax/non-cast,1,0,0,0,0,0,1
Dax/Garak,0,1,0,0,0,0,1
Torias Dax/non-cast,1,0,0,0,0,0,1
Cox/non-cast,1,0,0,0,0,0,1
Cox/Kira Nerys,1,0,0,0,0,0,1
Kira Nerys/Natima Lang,1,0,0,0,0,0,1
Pel/non-cast,0,0,1,0,1,0,2
Leeta/Quark,1,0,0,0,0,0,1
Elim Garak/Winn Adami,1,0,0,0,0,0,1
Emergency Medical Hologram Mark II/non-cast,0,1,0,0,0,0,1
Ishka/Jadzia Dax,1,0,0,0,0,0,1
Odo/Skrain Dukat,1,0,0,0,0,0,1
Elim Garak/Opaka,0,1,0,0,0,0,1
Elim Garak/Luther Sloan,0,1,0,0,0,0,1
Lauren/non-cast,1,0,0,0,0,0,1
Jadzia Dax/Jennifer Sisko,1,0,0,0,0,0,1
Vash/non-cast,0,1,0,0,0,0,1
Borath/Weyoun,0,0,1,0,0,0,1
Throlo Sh'shirros/ToloS | Qolar,0,1,0,0,0,0,1
Luaran/Yelgrun,0,1,0,0,0,0,1
Julianna/non-cast,0,1,0,0,0,0,1
Lantash/Sam Carter,0,1,0,0,0,0,1
Martouf/Sam Carter,0,1,0,0,0,0,1
Iliana Ghemor/Tora Ziyal,1,0,0,0,0,0,1
Ezri Dax/Vic Fontaine,0,1,0,0,0,0,1
Jean-Luc Picard/non-cast,1,0,0,0,0,0,1
Ezri Dax/Lauren,1,0,0,0,0,0,1
Zek/background Leeta,1,0,0,0,0,0,1
Ezri Dax/Skrain Dukat,1,0,0,0,0,0,1
Deyos/Weyoun,0,1,0,0,0,0,1
Skrain Dukat/Vreenak,0,1,0,0,0,0,1
Dax/Kira Nerys,1,0,0,0,0,0,1
Martok/Sirella,1,0,0,0,0,0,1
Elim Garak/Keevan,0,1,0,0,0,0,1
Ryan Ross/Spencer Smith,1,0,0,0,0,0,1
Victoria Asher/non-cast,1,0,0,0,0,0,1
Mareel/Verad,1,0,0,0,0,0,1
Kira Nerys/Vic Fontaine,1,0,0,0,0,0,1
Sikozu Svala Shanti Sugaysi Shanu/non-cast,1,0,0,0,0,0,1
Troy Barnes/non-cast,1,0,0,0,0,0,1
Alexander Rozhenko/Lauren,0,0,1,0,0,0,1
Dax/Jadzia Dax,1,0,0,0,0,0,1
Bareil Antos/Winn Adami,0,1,0,0,0,0,1
William Riker/non-cast,1,0,0,0,0,0,1
Boday/Jadzia Dax,1,0,0,0,0,0,1
Jake Sisko/Laira,1,0,0,0,0,0,1
Jake Sisko/Mardah,1,0,0,0,0,0,1
Jennifer Sisko/Miles O'Brien,0,0,1,0,0,0,1
Prinadora/Rom,1,0,0,0,0,0,1
Lela Dax/non-cast,0,1,0,0,0,0,1
Corat Damar/Gul Rusot,1,1,0,0,0,0,2
Lenara Kahn/background Grilka,1,0,0,0,0,0,1
Julian Bashir/Tom Paris,0,0,1,1,1,0,3
Elim Garak/Q,1,0,0,0,0,0,1
Elim Garak/Jack,0,1,0,0,0,0,1
Corat Damar/Jadzia Dax,1,0,0,0,0,0,1
Athra Dukat/Tora Naprem,1,0,0,0,0,0,1
Kira Nerys/Tahna Los,0,1,0,0,0,0,1
Kira Nerys/Kira Reon,0,1,0,0,0,0,1
Alexander Rozhenko/non-cast,1,0,0,0,0,0,1
Kira Meru/non-cast,0,1,0,0,0,0,1
Kira Nerys/Lenara Kahn,1,0,0,0,0,0,1
Lwaxana Troi/Mora Pol,0,1,0,0,0,0,1
Gowron/Julian Bashir,0,0,1,1,0,0,2
Elim Garak/Kai Winn,1,0,0,0,0,0,1
Michael Eddington/Rebecca Sullivan,1,0,0,0,0,0,1
Deral/Jadzia Dax,1,0,0,0,0,0,1
Kira Nerys/OFC,1,0,0,0,0,0,1
Gowron/non-cast,1,0,0,0,0,0,1
Dutch | Yalena Yardeen/non-cast,0,0,0,1,0,0,1
Tuvok (Star Trek)/non-cast,0,1,0,0,0,0,1
Elim Garak/Procal Dukat,1,0,0,0,0,0,1
Keevan/Kilana,0,0,1,1,0,0,2
Gerard Way/non-cast,1,0,0,0,0,0,1
Quark/Vash,0,1,0,0,0,0,1
Miles O'Brien/Owen Lars,1,0,0,0,0,0,1
Bareil Antos/Julian Bashir,1,0,0,0,0,0,1
Miles O'Brien/Worf,1,0,0,0,0,0,1
Jadzia Dax/Jadzia Dax,0,1,0,0,0,0,1
Vislor Turlough/non-cast,1,0,0,0,0,0,1
Lwaxana Troi/Quark,1,0,0,0,0,0,1
Elim Garak/Morn,1,0,0,0,0,0,1
Elim Garak/Worf (Star Trek: TNG,1,0,0,0,0,0,1
Kimara Cretak/non-cast,1,0,0,0,0,0,1
Jack/non-cast,1,0,0,0,0,0,1
Julian Bashir/Kukalaka,0,0,0,0,0,1,1
Tekeny Ghemor/non-cast,0,0,0,0,1,0,1
Kai Winn/Skrain Dukat,1,0,0,0,0,0,1
Gilora Rejal/Nal Dejar,1,0,0,0,0,0,1
Corat Damar/Niala Damar,1,0,0,0,0,0,1
Kelas Parmak/Pythas Lok,0,1,0,0,0,0,1
Male OC/non-cast,1,0,0,0,0,0,1
justice league/non-cast,0,0,0,1,0,0,1
Julian Bashir/Lauren,1,0,0,0,0,0,1
Total,6441,1585,244,188,174,17,8649
